/* Qwerty
 * ,-----------------------------------------------------------------------------------.
 * | Tab  |   Q  |   W  |   E  |   R  |   T  |   Y  |   U  |   I  |   O  |   P  | Bksp |
 * |------+------+------+------+------+------+------+------+------+------+------+------|
 * | Esc  |   A  |   S  |   D  |   F  |   G  |   H  |   J  |   K  |   L  |   ;  |  "   |
 * |------+------+------+------+------+------+------+------+------+------+------+------|
 * | Shift|   Z  |   X  |   C  |   V  |   B  |   N  |   M  |   ,  |   .  |   /  |Enter |
 * |------+------+------+------+------+------+------+------+------+------+------+------|
 * | BLTog| Ctrl | GUI  |  Alt |Lower |    Space    |Raise | Left | Down |  Up  |Right |
 * `-----------------------------------------------------------------------------------'
 */
 /* Lower
 * ,-----------------------------------------------------------------------------------.
 * |   ~  |   !  |   @  |   #  |   $  |   %  |   ^  |   &  |   *  |   (  |   )  | Bksp |
 * |------+------+------+------+------+------+------+------+------+------+------+------|
 * | Del  |  F1  |  F2  |  F3  |  F4  |  F5  |  F6  |   _  |   +  |   {  |   }  |  |   |
 * |------+------+------+------+------+------+------+------+------+------+------+------|
 * |      |  F7  |  F8  |  F9  |  F10 |  F11 |  F12 |   <  |  >  | | Home | End  |     |
 * |------+------+------+------+------+------+------+------+------+------+------+------|
 * |      |      |      |      |      |             |      | Next | Vol- | Vol+ | Play |
 * `-----------------------------------------------------------------------------------'
 */
 /* Raise
 * ,-----------------------------------------------------------------------------------.
 * |   `  |   1  |   2  |   3  |   4  |   5  |   6  |   7  |   8  |   9  |   0  | Bksp |
 * |------+------+------+------+------+------+------+------+------+------+------+------|
 * | Del  |  F1  |  F2  |  F3  |  F4  |  F5  |  F6  |   -  |   =  |   [  |   ]  |  \   |
 * |------+------+------+------+------+------+------+------+------+------+------+------|
 * |      |  F7  |  F8  |  F9  |  F10 |  F11 |  F12 |  ´   |ISO / |Pg Up |Pg Dn |      |
 * |------+------+------+------+------+------+------+------+------+------+------+------|
 * |      |      |      |      |      |             |      | Next | Vol- | Vol+ | Play |
 * `-----------------------------------------------------------------------------------'
 */
